111111
1C0C1
10E01
1C0P1
11111