1111111111111111111111111
1P00000000000000000000001
1011111111110111111111101
1010000000010100000000101
1010111111010111111110101
1010100000010000000000101
1010111111111111111100101
1010000000000000000100101
1011111111111111110100101
1000000000000000000000001
10000000000000000000000E1
1111111111111111111111111
