1111111111111111111111111
1P000000000000000000000C1
1011111111110111111111101
1010000000010100000000101
1010111111010111111110101
10101C000001C000000000101
1010111111111111111100101
10100P0000000000000100101
1011111111111111110100101
1000000000000C00000000001
10000000000000000000000E1
1111111111111111111111111
