1111111111111111111111111
1000000000000000000000001
1011111111110P01111111101
1010000000010001C00000101
1010111111010001111110101
10101C0000010000000000001
1010111111111111111111101
1010000000000000000000001
1011111111111111111111111
1000000000000C00000000001
1000000000000000000000001
1111111111111111111111111